12
1,6,3,6,3,5,7,5,7,5,5,6
3,13,14,11,15,5,15,4,9,5,7,14
11,6,10,10,9,6,9,6,3,5,12,8
10,9,13,12,3,15,7,13,13,6,3,6
9, 7, 6,3,14,8,8,3,5,13,12,10
1,12,11,14,8,3,6,10,3, 6,3,12
3,7,12,11,4,11,12,9,14,11,13,6
8,11,5,15,4,9,5,6,8,10,3,14
3,13,6,9,7,4,3,14,3,13,14,10
9,6,11,6,8,3,12,9,15,7,14,8
3,15,15,14,2,9,5,6,10,8,9,6
8,9,12,9,13,5,5,12,9,5,5,12
